 #######
 #     ####
 # ###O   #
##    # # #
# O#X X # #
# #  O  # #
# # XXX#O #
# # #    ##
#   O### ##
####      #
   #####  #
       #P #
       ####
