##########
#    P   #
#        #
#  XO  ###
#        #
# OX     #
##########
