##########
#      P #
#  X   X #
####XX####
#O      O#
#O      O#
##########
