############
#        O #
# X P   ####
#          #
#######    #
#  O ##    ##############
#    ##             #  O#
#                       #
#      XX           #   #
#      #   ##############
############
