#####
#  P#
# XX# ###
# X # #O#
### ###O#
 ##    O#
 #   #  #
 #   ####
 #####
