#####
#   #####
#   #   #
##     O#
### ###O#
# X # #O#
# XX# ###
#P  #
#####
