  #######
  #     #
  # X P #
##### # #
# X     #
#  #X## ##
#OOX  #  #
#OO      #
##########
