########
#O   X #
#OX  # #
#O# #  #
### # ##
 # X  #
 #P ###
 #####
