 ########
##OO#   #
# OO# X ##
# P X  X #
##X###   #
 #     ###
 #######
